####
# OWBus
####

OWBus	KEYWORD1
Address	KEYWORD1

toString	KEYWORD2
isValid		KEYWORD2
getFamily	KEYWORD2
getFamilyCode	KEYWORD2
getOWTechLayer	KEYWORD2
search_reset	KEYWORD2
search_next	KEYWORD2
getDeviceCount	KEYWORD2
launchTemperatureAcquisition	KEYWORD2

####
# OWDevice
####

OWDevice	KEYWORD1

getOWCommand	KEYWORD2
getOWCapability	KEYWORD2
getBus	KEYWORD2
getAddress	KEYWORD2
isParasitePowered	KEYWORD2
getName	KEYWORD2

CONVERT_T	LITERAL1
WRITE_SCRATCHPAD	LITERAL1
READ_SCRATCHPAD	LITERAL1
COPY_SCRATCHPAD	LITERAL1
RECALL_E2	LITERAL1
PIO_READ	LITERAL1
PIO_WRITE	LITERAL1
WRITE_STATUS	LITERAL1
READ_STATUS	LITERAL1
RESUME	LITERAL1
READ_POWER_SUPPLY	LITERAL1
CHANNEL_ACCESS	LITERAL1

TEMPERATURE	LITERAL1
PIO	LITERAL1
EEPROM	LITERAL1
TEMPERATURE_ALARM	LITERAL1
PIO_ALARM	LITERAL1

####
# OWScratchpad
####

OWScratchpad	KEYWORD1

readScratchpad	KEYWORD2
writeScratchpad	KEYWORD2
isValidScratchpad	KEYWORD2
forceInvalidScratchpad	KEYWORD2

####
# DS18B20
####

DS18B20	KEYWORD1

BAD_TEMPERATURE	LITERAL1
FAMILY_CODE	LITERAL1

getConversionDelay	KEYWORD2
getResolution	KEYWORD2
setResolution	KEYWORD2

SCRATCHPAD_INDEX	LITERAL1
TEMPERATURE_LSB	LITERAL1
TEMPERATURE_MSB	LITERAL1
HIGH_ALARM_TEMPERATURE	LITERAL1
LOW_ALARM_TEMPERATURE	LITERAL1
CONFIGURATION	LITERAL1
SCRATCHPAD_CRC	LITERAL1

isValidScratchpad	KEYWORD2
writeScratchpad	KEYWORD2
forceInvalidScratchpad	KEYWORD2
readLastTemperature	KEYWORD2
getTemperature	KEYWORD2

####
# DS28EA00
####

DS28EA00	KEYWORD1

####
# DS2406
####

DS2406	KEYWORD1
ChannelControl	KEYWORD1
ChannelInfo	KEYWORD1
StatusMemory	KEYWORD1

LATCH	LITERAL1
FLIPFLOP	LITERAL1
PIO	LITERAL1

checkArchitecture	KEYWORD2
clear	KEYWORD2
hasPIOB	KEYWORD2
latcheA	KEYWORD2
latcheB	KEYWORD2
getPIOA	KEYWORD2
getPIOB	KEYWORD2
arePIOsValid	KEYWORD2
readPIOs	KEYWORD2
writePIOs	KEYWORD2
setPIOA	KEYWORD2
setPIOB	KEYWORD2

####
# DS2413
####

DS2413	KEYWORD1

PIObitsvalue	LITERAL1
PIOAbit	LITERAL1
PIOBbit	LITERAL1
PIOmask	LITERAL1
PIONONEmask	LITERAL1
PIOAmask	LITERAL1
PIOBmask	LITERAL1

arePIOsValid	KEYWORD2


